R       800 600

SO            ./imgsrcs/wall_2.xpm

NO         ./imgsrcs/wall_1.xpm

        WE             ./imgsrcs/wall_3.xpm
        S  ./imgsrcs/sprite_1.xpm


    EA ./imgsrcs/wall_4.xpm


C 0,0,255
F 255,255,255



       11111111111111111111111111
       10000000000000000000000001
       10000000000000000000000001
       11000000000222222200020001
       10000000000000000000000001
       100000000000000000000S0001
       11111111111111111111111111
