R       800 600

SO            ./imgsrcs/wall_2.xpm

NO         ./imgsrcs/wall_1.xpm

        WE             ./imgsrcs/wall_3.xpm
        S  ./imgsrcs/sprite_1.xpm


    EA ./imgsrcs/wall_4.xpm


C 0,0,255
F 255,255,255


111    11111111111111111111111111
101    10000000000000000000000001
111    10000000000000000000000001
       10000000000000000000000001
       10000000000000000000000001
       100000000000000000000000N1
       11111111111111111111111111
