R      800 600
NO         ./imgsrcs/wall_1.xpm

SO            ./imgsrcs/wall_2.xpm


        WE             ./imgsrcs/wall_3.xpm
        S  ./imgsrcs/sprite_1.xpm


    EA ./imgsrcs/wall_4.xpm


F 255,255,255
C 0,255,0


11111111111111111111111111
10000000000000000000000001
10000000000000000000000001
10000000000000000000000001
10000000000000000000000001
10000000000000000000000N01
11111111111111111111111111
